#1
8
9
11252234
41346235
56664123
01423634
01561632
02346551
13236262
31216112
02314641
10000000
00000000
03000000
00000000
00000000
00000000
00030030
00000000
00000002